202,202,202,202,101,101,101,202,202,202,202,202,202,202,202,202,202,202,202,202,202,202,202,202,202,202,202,202,202,202,202,202,202,202,202,202,202,202,202,202,202,202,202,202,202,202,202,202,202,202,202,202,202,202,202,202,202,202,202,202,202,202,202,202,202,202,202,202,202,202,202,202,202,202,202,202,202,202,202,202,,0,,
202,101,101,101,101,101,101,101,101,101,201,101,101,101,101,101,101,101,101,101,101,101,101,101,101,101,101,101,201,201,201,201,101,101,101,101,101,101,101,101,101,101,101,101,101,101,101,101,101,101,201,201,201,201,101,101,101,101,101,101,101,101,101,101,101,101,101,101,101,101,101,201,101,101,101,101,101,101,101,202,,1,,
202,101,101,101,101,101,101,101,101,101,201,101,101,101,101,101,101,101,101,101,101,101,101,101,101,101,101,101,201,201,201,201,101,101,101,101,101,101,101,101,101,101,101,101,101,101,101,101,101,101,201,201,201,201,101,101,101,101,101,101,101,101,101,101,101,101,101,101,101,101,101,201,101,101,101,101,101,101,101,202,,2,,
202,101,101,101,101,101,101,101,101,101,201,101,101,101,101,101,101,101,101,101,101,101,101,101,101,101,101,101,201,201,201,201,101,101,101,101,101,101,101,101,101,101,101,101,101,101,101,101,101,101,201,201,201,201,101,101,101,101,101,101,101,101,101,101,101,101,101,101,101,101,101,201,101,101,101,101,101,101,101,202,,3,,
202,101,101,101,101,101,101,101,101,101,201,101,101,101,101,101,101,101,101,101,101,101,101,101,101,101,101,101,201,201,201,201,101,101,101,101,101,101,101,101,101,101,101,101,101,101,101,101,101,101,201,201,201,201,101,101,101,101,101,101,101,101,101,101,101,101,101,101,101,101,101,201,101,101,101,101,101,101,101,202,,4,,
202,101,101,101,101,101,101,101,101,101,201,101,101,101,101,101,101,101,101,101,101,101,101,101,101,101,101,101,201,201,201,201,101,101,101,101,101,101,101,101,101,101,101,101,101,101,101,101,101,101,201,201,201,201,101,101,101,101,101,101,101,101,101,101,101,101,101,101,101,101,101,201,101,101,101,101,101,101,101,202,,5,,
202,101,101,101,101,101,101,101,101,101,201,101,101,101,101,101,101,101,101,101,101,101,101,101,101,101,101,101,201,201,201,201,101,101,101,101,101,101,101,101,101,101,101,101,101,101,101,101,101,101,201,201,201,201,101,101,101,101,101,101,101,101,101,101,101,101,101,101,101,101,101,201,101,101,101,101,101,101,101,202,,6,,
202,101,101,101,101,101,101,101,101,101,201,101,101,101,101,101,101,101,101,101,101,101,101,101,101,101,101,101,201,201,201,201,101,101,101,101,101,101,101,101,101,101,101,101,101,101,101,101,101,101,201,201,201,201,101,101,101,101,101,101,101,101,101,101,101,101,101,101,101,101,101,201,101,101,101,101,101,101,101,202,,7,,
202,101,101,101,101,101,101,101,101,101,201,101,101,101,101,101,101,101,101,101,101,101,101,101,101,101,101,101,201,201,201,201,101,101,101,101,101,101,101,101,101,101,101,101,101,101,101,101,101,101,201,201,201,201,101,101,101,101,101,101,101,101,101,101,101,101,101,101,101,101,101,101,101,101,101,101,101,101,101,202,,8,,
202,101,101,101,101,101,101,101,101,101,201,101,101,101,101,101,101,101,101,101,101,101,101,101,101,101,101,101,201,201,201,201,101,101,101,101,101,101,101,101,101,101,101,101,101,101,101,101,101,101,201,201,201,201,101,101,101,101,101,101,101,101,101,101,101,101,101,101,101,101,101,101,101,101,101,101,101,101,101,202,,9,,
202,101,101,101,101,101,101,101,101,101,101,101,101,101,101,101,101,101,101,101,101,101,101,101,101,101,101,101,201,201,201,201,101,101,101,101,101,101,101,101,101,101,101,101,101,101,101,101,101,101,201,201,201,201,101,101,101,101,101,101,101,101,101,101,101,101,101,101,101,101,101,101,101,101,101,101,101,101,101,202,,10,,
202,101,101,101,101,101,101,101,101,101,101,101,101,101,101,101,101,101,101,101,101,101,101,101,101,101,101,101,201,201,201,201,101,101,101,101,101,101,101,101,101,101,101,101,101,101,101,101,101,101,201,201,201,201,101,101,101,101,101,101,101,101,101,101,101,101,101,101,101,101,101,101,101,101,101,101,101,101,101,202,,11,,
202,101,101,101,101,101,101,101,101,101,101,101,101,101,101,101,101,101,101,101,101,101,101,101,101,101,101,101,201,201,201,201,101,101,101,101,101,101,101,101,101,101,101,101,101,101,101,101,101,101,201,201,201,201,101,101,101,101,101,101,101,101,101,101,101,101,101,101,101,101,101,101,101,101,101,101,101,101,101,202,,12,,
202,101,101,101,101,101,101,101,101,101,101,101,101,101,101,101,101,101,101,101,101,101,101,101,101,101,101,101,201,201,201,201,101,101,101,101,101,101,101,101,101,101,101,101,101,101,101,101,101,101,201,201,201,201,101,101,101,101,101,101,101,101,101,101,101,101,101,101,101,101,101,101,101,101,101,101,101,101,101,202,,13,,
202,101,101,101,101,101,101,101,101,101,101,101,101,101,101,101,101,101,101,101,101,101,101,101,101,101,101,101,201,201,201,201,101,101,101,101,101,101,101,101,101,101,101,101,101,101,101,101,101,101,201,201,201,201,101,101,101,101,101,101,101,101,101,101,101,101,101,101,101,101,101,101,101,101,101,101,101,101,101,202,,14,,
202,101,101,101,101,101,101,101,101,101,101,101,101,101,101,101,101,101,101,101,101,101,101,101,101,101,101,101,201,201,201,201,101,101,101,101,101,101,101,101,101,101,101,101,101,101,101,101,101,101,201,201,201,201,101,101,101,101,101,101,101,101,101,101,101,101,101,101,101,101,101,101,101,101,101,101,101,101,101,202,,15,,
202,101,101,101,101,101,101,101,101,101,101,101,101,101,101,101,101,101,101,101,101,101,101,101,101,101,101,101,201,201,201,201,101,101,101,101,101,101,101,101,101,101,101,101,101,101,101,101,101,101,201,201,201,201,101,101,101,101,101,101,101,101,101,101,101,101,101,101,101,101,101,201,101,101,101,101,101,101,101,202,,16,,
202,101,101,101,101,101,101,101,101,101,201,101,101,101,101,101,101,101,101,101,101,101,101,101,101,101,101,101,201,201,201,201,101,101,101,101,101,101,101,101,101,101,101,101,101,101,101,101,101,101,201,201,201,201,101,101,101,101,101,101,101,101,101,101,101,101,101,101,101,101,101,201,101,101,101,101,101,101,101,202,,17,,
202,101,101,101,101,101,101,101,101,101,201,101,101,101,101,101,101,101,101,101,101,101,101,101,101,101,101,101,201,201,201,201,101,101,101,101,101,101,101,101,101,101,101,101,101,101,101,101,101,101,201,201,201,201,101,101,101,101,101,101,101,101,101,101,101,101,101,101,101,101,101,201,101,101,101,101,101,101,101,202,,18,,
202,101,101,101,101,101,101,101,101,101,201,101,101,101,101,101,101,101,101,101,101,101,101,101,101,101,101,101,201,201,201,201,101,101,101,101,101,101,101,101,101,101,101,101,101,101,101,101,101,101,201,201,201,201,101,101,101,101,101,101,101,101,101,101,101,101,101,101,101,101,101,201,101,101,101,101,101,101,101,202,,19,,
202,101,101,101,101,101,101,101,101,101,201,101,101,101,101,101,101,101,101,101,101,101,101,101,101,101,101,101,201,201,201,201,101,101,101,101,101,101,101,101,101,101,101,101,101,101,101,101,101,101,201,201,201,201,101,101,101,101,101,101,101,101,101,101,101,101,101,101,101,101,101,201,101,101,101,101,101,101,101,202,,20,,
202,101,101,101,101,101,101,101,101,101,201,101,101,101,101,101,101,101,101,101,101,101,101,101,101,101,101,101,201,201,201,201,101,101,101,101,101,101,101,101,101,101,101,101,101,101,101,101,101,101,201,201,201,201,101,101,101,101,101,101,101,101,101,101,101,101,101,101,101,101,101,201,101,101,101,101,101,101,101,202,,21,,
202,101,101,101,101,101,101,101,101,101,201,101,101,101,101,101,101,101,101,101,101,101,101,101,101,101,101,101,201,201,201,201,101,101,101,101,101,101,101,101,101,101,101,101,101,101,101,101,101,101,201,201,201,201,101,101,101,101,101,101,101,101,101,101,101,101,101,101,101,101,101,201,101,101,101,101,101,101,101,202,,22,,
202,101,101,101,101,101,101,101,101,101,201,101,101,101,101,101,101,101,101,101,101,101,101,101,101,101,101,101,201,201,201,201,101,101,101,101,101,101,101,101,101,101,101,101,101,101,101,101,101,101,201,201,201,201,101,101,101,101,101,101,101,101,101,101,101,101,101,101,101,101,101,201,101,101,101,101,101,101,101,202,,23,,
202,101,101,101,101,101,101,101,101,101,201,101,101,101,101,101,101,101,101,101,101,101,101,101,101,101,101,101,201,201,201,201,101,101,101,101,101,101,101,101,101,101,101,101,101,101,101,101,101,101,201,201,201,201,101,101,101,101,101,101,101,101,101,101,101,101,101,101,101,101,101,201,101,101,101,101,101,101,101,202,,24,,
202,101,101,101,101,101,101,101,101,101,201,101,101,101,101,101,101,101,101,101,101,101,101,101,101,101,101,101,201,201,201,201,201,201,201,201,201,201,201,201,201,201,201,201,201,201,201,201,201,201,201,201,201,201,101,101,101,101,101,101,101,101,101,101,101,101,101,101,101,101,101,201,101,101,101,101,101,101,101,202,,25,,
202,101,101,101,101,101,101,101,101,101,201,101,101,101,101,101,101,101,101,101,101,101,101,101,101,101,101,101,201,201,201,201,201,201,201,201,201,201,201,201,201,201,201,201,201,201,201,201,201,201,201,201,201,201,101,101,101,101,101,101,101,101,101,101,101,101,101,101,101,101,101,201,101,101,101,101,101,101,101,202,,26,,
202,101,101,101,101,101,101,101,101,101,201,101,101,101,101,101,101,101,101,101,101,101,101,101,101,101,101,101,201,201,201,201,201,201,201,201,201,201,201,201,201,201,201,201,201,201,201,201,201,201,201,201,201,201,101,101,101,101,101,101,101,101,101,101,101,101,101,101,101,101,101,201,101,101,101,101,101,101,101,202,,27,,
202,101,101,101,101,101,101,101,101,101,201,201,201,201,201,201,201,201,201,201,201,201,201,201,201,201,201,201,201,201,201,201,201,201,201,201,201,201,201,201,201,201,201,201,201,201,201,201,201,201,201,201,201,201,201,201,201,201,201,201,201,201,201,201,201,201,201,201,201,201,201,201,101,101,101,101,101,101,101,202,,28,,
202,101,101,101,101,101,101,101,101,101,101,101,101,101,101,101,101,101,101,101,101,101,101,101,101,101,101,101,101,101,101,101,101,101,101,101,101,101,101,101,101,101,101,101,101,101,101,101,101,101,101,101,101,101,101,101,101,101,101,101,101,101,101,101,101,101,101,101,101,101,101,101,101,101,101,101,101,101,101,202,,29,,
202,101,101,101,101,101,101,101,101,101,101,101,101,101,101,101,101,101,101,101,101,101,101,101,101,101,101,101,101,101,101,101,101,101,101,101,101,101,101,101,101,101,101,101,101,101,101,101,101,101,101,101,101,101,101,101,101,101,101,101,101,101,101,101,101,101,101,101,101,101,101,101,101,101,101,101,101,101,101,202,,30,,
202,101,101,101,101,101,101,101,101,101,101,101,101,101,101,101,101,101,101,101,101,101,101,101,101,101,101,101,101,101,101,101,101,101,101,101,101,101,101,101,101,101,101,101,101,101,101,101,101,101,101,101,101,101,101,101,101,101,101,101,101,101,101,101,101,101,101,101,101,101,101,101,101,101,101,101,101,101,101,202,,31,,
202,101,101,101,101,101,101,101,101,101,101,101,101,101,101,101,101,101,101,101,101,101,101,101,101,101,101,101,101,101,101,101,101,101,101,101,101,101,101,101,101,101,101,101,101,101,101,101,101,101,101,101,101,101,101,101,101,101,101,101,101,101,101,101,101,101,101,101,101,101,101,101,101,101,101,101,101,101,101,202,,32,,
202,101,101,101,101,101,101,101,101,101,101,101,101,101,101,101,101,101,101,101,101,101,101,101,101,101,101,101,101,101,101,101,101,101,101,101,101,101,101,101,101,101,101,101,101,101,101,101,101,101,101,101,101,101,101,101,101,101,101,101,101,101,101,101,101,101,101,101,101,101,101,101,101,101,101,101,101,101,101,202,,33,,
202,101,101,101,101,101,101,101,101,101,101,101,101,101,101,101,101,101,101,101,101,101,101,101,101,101,101,101,101,101,101,101,101,101,101,101,101,101,101,101,101,101,101,101,101,101,101,101,101,101,101,101,101,101,101,101,101,101,101,101,101,101,101,101,101,101,101,101,101,101,101,101,101,101,101,101,101,101,101,202,,34,,
202,101,101,101,101,101,101,101,101,101,101,101,101,101,101,101,101,101,101,101,101,101,101,101,101,101,101,101,101,101,101,101,101,101,101,101,101,101,101,101,101,101,101,101,101,101,101,101,101,101,101,101,101,101,101,101,101,101,101,101,101,101,101,101,101,101,101,101,101,101,101,101,101,101,101,101,101,101,101,202,,35,,
202,101,101,101,101,101,101,101,101,101,101,101,101,101,101,101,101,101,101,101,101,101,101,101,101,101,101,101,101,101,101,101,101,101,101,101,101,101,101,101,101,101,101,101,101,101,101,101,101,101,101,101,101,101,101,101,101,101,101,101,101,101,101,101,101,101,101,101,101,101,101,101,101,101,101,101,101,101,101,202,,36,,
202,201,201,201,201,201,101,101,101,101,101,101,201,201,201,201,201,201,201,201,201,201,201,201,201,201,201,201,201,201,201,201,201,201,201,201,201,101,101,101,101,101,101,101,201,201,201,201,201,201,201,201,201,201,201,201,201,201,201,201,201,201,201,201,201,201,201,101,101,101,101,101,201,201,201,201,201,201,201,202,,37,,
202,101,101,101,101,101,101,101,101,101,101,101,101,101,101,101,101,101,101,201,201,101,101,101,101,101,101,101,101,101,101,101,101,101,101,101,101,101,101,101,101,101,101,101,101,101,101,101,101,101,101,101,101,101,101,101,101,101,201,201,101,101,101,101,101,101,101,101,101,101,101,101,101,101,101,101,101,101,101,202,,38,,
202,101,101,101,101,101,101,101,101,101,101,101,101,101,101,101,101,101,101,201,201,101,101,101,101,101,101,101,101,101,101,101,101,101,101,101,101,101,101,101,101,101,101,101,101,101,101,101,101,101,101,101,101,101,101,101,101,101,201,201,101,101,101,101,101,101,101,101,101,101,101,101,101,101,101,101,101,101,101,202,,39,,
202,101,101,101,101,101,101,101,101,101,101,101,101,101,101,101,101,101,101,201,201,101,101,101,101,101,101,101,101,101,101,101,101,101,101,101,101,101,101,101,101,101,101,101,101,101,101,101,101,101,101,101,101,101,101,101,101,101,201,201,101,101,101,101,101,101,101,101,101,101,101,101,101,101,101,101,101,101,101,202,,40,,center
202,101,101,101,101,101,101,101,101,101,101,101,101,101,101,101,101,101,101,201,201,101,101,101,101,101,101,101,101,101,101,101,101,101,101,101,101,101,101,101,101,101,101,101,101,101,101,101,101,101,101,101,101,101,101,101,101,101,201,201,101,101,101,101,101,101,101,101,101,101,101,101,101,101,101,101,101,101,101,202,,41,,
202,101,101,101,101,101,101,101,101,101,101,101,101,101,101,101,101,101,101,201,201,101,101,101,101,101,101,101,101,101,101,101,101,101,101,101,101,101,101,101,101,101,101,101,101,101,101,101,101,101,101,101,101,101,101,101,101,101,201,201,101,101,101,101,101,101,101,101,101,101,101,101,101,101,101,101,101,101,101,202,,42,,
202,101,101,101,101,101,101,101,101,101,101,101,101,101,101,101,101,101,101,201,201,101,101,101,101,101,101,101,101,101,101,101,101,101,101,101,101,101,101,101,101,101,101,101,101,101,101,101,101,101,101,101,101,101,101,101,101,101,201,201,101,101,101,101,101,101,101,101,101,101,101,101,101,101,101,101,101,101,101,202,,43,,
202,101,101,101,101,101,101,101,101,101,101,101,101,101,101,101,101,101,101,201,201,101,101,101,101,101,101,101,101,101,101,101,101,101,101,101,101,101,101,101,101,101,101,101,101,101,101,101,101,101,101,101,101,101,101,101,101,101,201,201,101,101,101,101,101,101,101,101,101,101,101,101,101,101,101,101,101,101,101,202,,44,,
202,101,101,101,101,101,101,101,101,101,101,101,101,101,101,101,101,101,101,201,201,101,101,101,101,101,101,101,101,101,101,101,101,101,101,101,101,101,101,101,101,101,101,101,101,101,101,101,101,101,101,101,101,101,101,101,101,101,201,201,101,101,101,101,101,101,101,101,101,101,101,101,101,101,101,101,101,101,101,202,,45,,
202,101,101,101,101,101,101,101,101,101,101,101,101,101,101,101,101,101,101,201,201,101,101,101,101,101,101,101,101,101,101,101,101,101,101,101,101,101,101,101,101,101,101,101,101,101,101,101,101,101,101,101,101,101,101,101,101,101,201,201,101,101,101,101,101,101,101,101,101,101,101,101,101,101,101,101,101,101,101,202,,46,,
202,101,101,101,101,101,101,101,101,101,101,101,101,101,101,101,101,101,101,201,201,101,101,101,101,101,101,101,101,201,201,201,201,201,201,201,201,201,201,201,201,201,201,201,201,201,201,201,201,201,201,101,101,101,101,101,101,101,201,201,101,101,101,101,101,101,101,101,101,101,101,101,101,101,101,101,101,101,101,202,,47,,
202,101,101,101,101,101,101,101,101,101,101,101,101,101,101,101,101,101,101,201,201,101,101,101,101,101,101,101,101,201,201,201,201,201,201,201,201,201,201,201,201,201,201,201,201,201,201,201,201,201,201,101,101,101,101,101,101,101,201,201,101,101,101,101,101,101,101,101,101,101,101,101,101,101,101,101,101,101,101,202,,48,,
202,101,101,101,101,101,101,101,101,101,101,101,101,101,101,101,101,101,101,201,201,101,101,101,101,101,101,101,101,101,101,101,101,101,101,101,101,101,101,101,101,101,101,101,101,101,101,101,101,101,101,101,101,101,101,101,101,101,201,201,101,101,101,101,101,101,101,101,101,101,101,101,101,101,101,101,101,101,101,202,,49,,
202,101,101,101,101,101,101,101,101,101,101,101,101,101,101,101,101,101,101,201,201,101,101,101,101,101,101,101,101,101,101,101,101,101,101,101,101,101,101,101,101,101,101,101,101,101,101,101,101,101,101,101,101,101,101,101,101,101,201,201,101,101,101,101,101,101,101,101,101,101,101,101,101,101,101,101,101,101,101,202,,50,,
202,101,101,101,101,101,101,101,101,101,101,101,101,101,101,101,101,101,101,201,201,101,101,101,101,101,101,101,101,101,101,101,101,101,101,101,101,101,101,101,101,101,101,101,101,101,101,101,101,101,101,101,101,101,101,101,101,101,201,201,101,101,101,101,101,101,101,101,101,101,101,101,101,101,101,101,101,101,101,202,,51,,
202,101,101,101,101,101,101,101,101,101,101,101,101,101,101,101,101,101,101,201,201,101,101,101,101,101,101,101,101,101,101,101,101,101,101,101,101,101,101,101,101,101,101,101,101,101,101,101,101,101,101,101,101,101,101,101,101,101,201,201,101,101,101,101,101,101,101,101,101,101,101,101,101,101,101,101,101,101,101,202,,52,,
202,101,101,101,101,101,101,101,101,101,101,101,101,101,101,101,101,101,101,201,201,101,101,101,101,101,101,101,101,101,101,101,101,101,101,101,101,101,101,101,101,101,101,101,101,101,101,101,101,101,101,101,101,101,101,101,101,101,201,201,101,101,101,101,101,101,101,101,101,101,101,101,101,101,101,101,101,101,101,202,,53,,
202,101,101,101,101,101,101,101,101,101,101,101,101,101,101,101,101,101,101,101,101,101,101,101,101,101,101,101,101,101,101,101,101,101,101,101,101,101,101,101,101,101,101,101,101,101,101,101,101,101,101,101,101,101,101,101,101,101,101,101,101,101,101,101,101,101,101,101,101,101,101,101,101,101,101,101,101,101,101,202,,54,,
202,101,101,101,101,101,101,101,101,101,101,101,101,101,101,101,101,101,101,101,101,101,101,101,101,101,101,101,101,101,101,101,101,101,101,101,101,101,101,101,101,101,101,101,101,101,101,101,101,101,101,101,101,101,101,101,101,101,101,101,101,101,101,101,101,101,101,101,101,101,101,101,101,101,101,101,101,101,101,202,,55,,
202,101,101,101,101,101,101,101,101,101,101,101,101,101,101,101,101,101,101,101,101,101,101,101,101,101,101,101,101,101,101,101,101,101,101,101,101,101,101,101,101,101,101,101,101,101,101,101,101,101,101,101,101,101,101,101,101,101,101,101,101,101,101,101,101,101,101,101,101,101,101,101,101,101,101,101,101,101,101,202,,56,,
202,101,101,101,101,101,101,101,101,101,101,101,101,101,101,101,101,101,101,101,101,101,101,101,101,101,101,101,101,101,101,101,101,101,101,101,101,101,101,101,101,101,101,101,101,101,101,101,101,101,101,101,101,101,101,101,101,101,101,101,101,101,101,101,101,101,101,101,101,101,101,101,101,101,101,101,101,101,101,202,,57,,
202,101,101,101,101,101,101,101,101,101,101,101,101,101,101,101,101,101,101,101,101,101,101,101,101,101,101,101,101,101,101,101,101,101,101,101,101,101,101,101,101,101,101,101,101,101,101,101,101,101,101,101,101,101,101,101,101,101,101,101,101,101,101,101,101,101,101,101,101,101,101,101,101,101,101,101,101,101,101,202,,58,,
202,101,101,101,101,101,101,101,101,101,101,101,101,101,101,101,101,101,101,101,101,101,101,101,101,101,101,101,101,101,101,101,101,101,101,101,101,101,101,101,101,101,101,101,101,101,101,101,101,101,101,101,101,101,101,101,101,101,101,101,101,101,101,101,101,101,101,101,101,101,101,101,101,101,101,101,101,101,101,202,,59,,
202,101,101,101,101,101,101,101,101,101,101,101,101,101,101,101,101,101,101,101,101,101,101,101,101,101,101,101,101,101,101,101,101,101,101,101,101,101,101,101,101,101,101,101,101,101,101,101,101,101,101,101,101,101,101,101,101,101,101,101,101,101,101,101,101,101,101,101,101,101,101,101,101,101,101,101,101,101,101,202,,60,,
202,101,101,101,101,101,101,101,101,101,101,101,101,101,101,101,101,101,101,101,101,101,101,101,101,101,101,101,101,101,101,101,101,101,101,101,101,101,101,101,101,101,101,101,101,101,101,101,101,101,101,101,101,101,101,101,101,101,101,101,101,101,101,101,101,101,101,101,101,101,101,101,101,101,101,101,101,101,101,202,,61,,
202,101,101,101,101,101,101,101,101,101,101,101,101,101,101,101,101,101,101,101,101,101,101,101,101,101,101,101,101,101,101,101,101,101,101,101,101,101,101,101,101,101,101,101,101,101,101,101,101,101,101,101,101,101,101,101,101,101,101,101,101,101,101,101,101,101,101,101,101,101,101,101,101,101,101,101,101,101,101,202,,62,,
202,101,101,101,101,101,101,101,101,101,101,101,101,101,101,101,101,101,101,101,101,101,101,101,101,101,101,101,101,101,101,101,101,101,101,101,101,101,101,101,101,101,101,101,101,101,101,101,101,101,101,101,101,101,101,101,101,101,101,101,101,101,101,101,101,101,101,101,101,101,101,101,101,101,101,101,101,101,101,202,,63,,
202,101,101,101,101,101,101,101,101,101,101,101,101,101,101,101,101,101,101,101,101,101,101,101,101,101,101,101,101,101,101,101,101,101,101,101,101,101,101,101,101,101,101,101,101,101,101,101,101,101,101,101,101,101,101,101,101,101,101,101,101,101,101,101,101,101,101,101,101,101,101,101,101,101,101,101,101,101,101,202,,64,,
202,101,101,101,101,101,101,101,101,101,101,101,101,101,101,101,101,101,101,101,101,101,101,101,101,101,101,101,101,101,101,101,101,101,101,101,101,101,101,101,101,101,101,101,101,101,101,101,101,101,101,101,101,101,101,101,101,101,101,101,101,101,101,101,101,101,101,101,101,101,101,101,101,101,101,101,101,101,101,202,,65,,
202,101,101,101,101,101,101,101,101,101,101,101,101,101,101,101,101,101,101,101,101,101,101,101,101,101,101,101,101,101,101,101,101,101,101,101,101,101,101,101,101,101,101,101,101,101,101,101,101,101,101,101,101,101,101,101,101,101,101,101,101,101,101,101,101,101,101,101,101,101,101,101,101,101,101,101,101,101,101,202,,66,,
202,101,101,101,101,101,101,101,101,101,101,101,101,101,101,101,101,101,101,101,101,101,101,101,101,101,101,101,101,101,101,101,101,101,101,101,101,101,101,101,101,101,101,101,101,101,101,101,101,101,101,101,101,101,101,101,101,101,101,101,101,101,101,101,101,101,101,101,101,101,101,101,101,101,101,101,101,101,101,202,,67,,
202,101,101,101,101,101,101,101,101,101,101,101,101,101,101,101,101,101,101,101,101,101,101,101,101,101,101,101,101,101,101,101,101,101,101,101,101,101,101,101,101,101,101,101,101,101,101,101,101,101,101,101,101,101,101,101,101,101,101,101,101,101,101,101,101,101,101,101,101,101,101,101,101,101,101,101,101,101,101,202,,68,,
202,101,101,101,101,101,101,101,101,101,101,101,101,101,101,101,101,101,101,101,101,101,101,101,101,101,101,101,101,101,101,101,101,101,101,101,101,101,101,101,101,101,101,101,101,101,101,101,101,101,101,101,101,101,101,101,101,101,101,101,101,101,101,101,101,101,101,101,101,101,101,101,101,101,101,101,101,101,101,202,,69,,
202,101,101,101,101,101,101,101,101,101,101,101,101,101,101,101,101,101,101,101,101,101,101,101,101,101,101,101,101,101,101,101,101,101,101,101,101,101,101,101,101,101,101,101,101,101,101,101,101,101,101,101,101,101,101,101,101,101,101,101,101,101,101,101,101,101,101,101,101,101,101,101,101,101,101,101,101,101,101,202,,70,,
202,101,101,101,101,101,101,101,101,101,101,101,101,101,101,101,101,101,101,101,101,101,101,101,101,101,101,101,101,101,101,101,101,101,101,101,101,101,101,101,101,101,101,101,101,101,101,101,101,101,101,101,101,101,101,101,101,101,101,101,101,101,101,101,101,101,101,101,101,101,101,101,101,101,101,101,101,101,101,202,,71,,
202,101,101,101,101,101,101,101,101,101,101,101,101,101,101,101,101,101,101,101,101,101,101,101,101,101,101,101,101,101,101,101,101,101,101,101,101,101,101,101,101,101,101,101,101,101,101,101,101,101,101,101,101,101,101,101,101,101,101,101,101,101,101,101,101,101,101,101,101,101,101,101,101,101,101,101,101,101,101,202,,72,,
202,101,101,101,101,101,101,101,101,101,101,101,101,101,101,101,101,101,101,101,101,101,101,101,101,101,101,101,101,101,101,101,101,101,101,101,101,101,101,101,101,101,101,101,101,101,101,101,101,101,101,101,101,101,101,101,101,101,101,101,101,101,101,101,101,101,101,101,101,101,101,101,101,101,101,101,101,101,101,202,,73,,
202,101,101,101,101,101,101,101,101,101,101,101,101,101,101,101,101,101,101,101,101,101,101,101,101,101,101,101,101,101,101,101,101,101,101,101,101,101,101,101,101,101,101,101,101,101,101,101,101,101,101,101,101,101,101,101,101,101,101,101,101,101,101,101,101,101,101,101,101,101,101,101,101,101,101,101,101,101,101,202,,74,,
202,101,101,101,101,101,101,101,101,101,101,101,101,101,101,101,101,101,101,101,101,101,101,101,101,101,101,101,101,101,101,101,101,101,101,101,101,101,101,101,101,101,101,101,101,101,101,101,101,101,101,101,101,101,101,101,101,101,101,101,101,101,101,101,101,101,101,101,101,101,101,101,101,101,101,101,101,101,101,202,,75,,
202,101,101,101,101,101,101,101,101,101,101,101,101,101,101,101,101,101,101,101,101,101,101,101,101,101,101,101,101,101,101,101,101,101,101,101,101,101,101,101,101,101,101,101,101,101,101,101,101,101,101,101,101,101,101,101,101,101,101,101,101,101,101,101,101,101,101,101,101,101,101,101,101,101,101,101,101,101,101,202,,76,,
202,101,101,101,101,101,101,101,101,101,101,101,101,101,101,101,101,101,101,101,101,101,101,101,101,101,101,101,101,101,101,101,101,101,101,101,101,101,101,101,101,101,101,101,101,101,101,101,101,101,101,101,101,101,101,101,101,101,101,101,101,101,101,101,101,101,101,101,101,101,101,101,101,101,101,101,101,101,101,202,,77,,
202,101,101,101,101,101,101,101,101,101,101,101,101,101,101,101,101,101,101,101,101,101,101,101,101,101,101,101,101,101,101,101,101,101,101,101,101,101,101,101,101,101,101,101,101,101,101,101,101,101,101,101,101,101,101,101,101,101,101,101,101,101,101,101,101,101,101,101,101,101,101,101,101,101,101,101,101,101,101,202,,78,,
202,101,101,101,101,101,101,101,101,101,101,101,101,101,101,101,101,101,101,101,101,101,101,101,101,101,101,101,101,101,101,101,101,101,101,101,101,101,101,101,101,101,101,101,101,101,101,101,101,101,101,101,101,101,101,101,101,101,101,101,101,101,101,101,101,101,101,101,101,101,101,101,101,101,101,101,101,101,101,202,,79,,
,,,,,,,,,,,,,,,,,,,,,,,,,,,,,,,,,,,,,,,,,,,,,,,,,,,,,,,,,,,,,,,,,,,,,,,,,,,,,,,,,,,
0,1,2,3,4,5,6,7,8,9,10,11,12,13,14,15,16,17,18,19,20,21,22,23,24,25,26,27,28,29,30,31,32,33,34,35,36,37,38,39,40,41,42,43,44,45,46,47,48,49,50,51,52,53,54,55,56,57,58,59,60,61,62,63,64,65,66,67,68,69,70,71,72,73,74,75,76,77,78,79,,,,
,,,,,,,,,,,,,,,,,,,,,,,,,,,,,,,,,,,,,,,,,,,,,,,,,,,,,,,,,,,,,,,,,,,,,,,,,,,,,,,,,,,
,,,,,,,,,,,,,,,1379,,,åüçıÉZÉã,1180,,,,,,,,,,,,,,,,,,,,,,,,,,,,,,,,,,,,,,,,,,,,,,,,,,,,,,,,,,,,,,,,
,,,,,,,,,,,,,,,2338,1379,,â°,60,,,,,,,,,,,,,,,,,,,,,center,,,,,,,,,,,,,,,,,,,,,,,,,,,,,,,,,,,,,,,,,,,
,,,,,,,,,,,,,,,,,,èc,14,,,,,,,,,,,,,,,,,,,,,,,,,,,,,,,,,,,,,,,,,,,,,,,,,,,,,,,,,,,,,,,,
